0 0 0 1 0 1 0 0
3 0 1 0 2 1 0 1
4 0 1 0 2 1 0 1
2 0 1 0 2 1 0 4
1 0 1 0 2 1 0 3
5 0 1 0 2 1 0 1
6 0 1 0 2 1 0 1
7 0 1 0 2 1 0 1
