l0
m32
30000000
33300C00
40030D00
00300004
00100303
00333000
00066550
00333330
