l7
m56
00000000
30000100
40030000
00302504
00000000
00066000
00000000
