l5
m32
00010000
02300035
00004000
33333333
00004000
0A0300D0
0C0300B0
