l0
m48
30000000
00000C00
40000D00
00000004
00000000
