l0
m70
00010000
02300035
00000000
00004000
33333333
00004000
00000000
0A0300D0
0C0300B0
00000000
