l0
m48
00000000
03000C00
00000D00
00010000
00000000
