l0
m32
00000000
30000000
40030000
00302504
00010003
00000000
00000000
70000000
