l17
m32
00000000
30000C00
40030D00
00300004
00010003
00000000
00066550
00000000
