l7
m32
00000000
30000C00
40030D00
00302504
00010003
00000000
00066550
70000000
