l0
m56
00000000
30000000
40030000
00302504
00000000
00066000
70000000